20 20 20 20 20 20 20 8 9 20 20 20 20 20 20 20
20 3 3 3 3 3 3 3 3 3 3 3 3 3 3 20
20 3 3 3 3 3 3 3 3 3 3 3 3 3 3 20
20 3 3 3 3 3 3 3 3 3 3 3 3 3 3 20
20 3 3 3 3 3 3 3 3 3 3 3 3 3 3 20
20 3 3 3 3 3 3 3 3 3 3 3 3 3 3 20
20 3 3 3 3 3 3 3 3 3 3 3 3 3 3 20
20 3 3 3 3 3 3 3 3 3 3 3 3 3 3 20
20 3 3 3 3 3 3 3 3 3 3 3 3 3 3 20
20 3 3 3 3 3 3 3 3 3 3 3 3 3 3 20
20 3 3 3 3 3 3 3 3 3 3 3 3 3 3 20
20 20 20 20 20 20 20 20 20 20 20 20 20 20 20 20
`