19 19 19 19 19 19 19 19 19 19 19 19 19 19 19 19 19 19 19 19 19 19 19 19 19 19 19 19 19 19 19 19 19 19 19 19 19 19 19 19 19 19 19 19 19 19 19 19 19 19 
19 19 19 19 19 19 19 19 19 19 19 19 19 19 19 19 19 19 19 19 19 19 19 19 19 19 19 19 19 19 19 19 19 19 19 19 19 19 19 19 19 19 19 19 19 19 19 19 19 19 
19 19 19 19 19 19 19 19 19 19 19 19 19 19 19 19 19 19 19 19 0 2 2 2 2 2 0 19 19 19 19 19 19 19 19 19 19 19 19 19 19 19 19 19 19 19 19 19 19 19 
19 19 19 19 19 19 19 19 19 19 19 19 19 19 19 19 19 19 19 19 2 2 2 2 2 2 2 19 19 19 19 19 19 19 19 19 19 19 19 19 19 19 19 19 19 19 19 19 19 19 
19 19 19 19 19 19 19 19 19 19 19 19 19 19 19 19 19 19 19 19 2 2 2 2 2 2 2 19 19 19 19 19 19 19 19 19 19 19 19 19 19 19 19 19 19 19 19 19 19 19 
19 19 19 19 19 19 19 19 19 19 19 19 19 19 19 19 19 19 19 19 2 2 2 2 2 2 2 19 19 19 19 19 19 19 19 19 19 19 19 19 19 19 19 19 19 19 19 19 19 19 
19 19 19 19 19 19 19 19 1 1 1 1 1 19 19 19 19 19 19 19 19 2 2 2 2 2 19 19 19 19 19 19 19 19 19 19 19 19 19 19 19 19 19 19 19 19 19 19 19 19 
19 19 19 19 19 19 19 19 1 3 3 3 1 19 19 19 19 19 19 19 0 0 0 5 0 0 0 19 19 19 19 19 19 0 5 5 5 5 5 5 5 19 19 19 19 19 19 19 19 19 
19 19 19 19 19 19 19 19 1 3 3 3 1 19 19 19 19 19 19 19 19 0 0 0 0 0 19 19 19 19 19 19 19 19 5 5 5 5 5 5 5 5 19 19 19 19 19 19 19 19 
19 19 19 19 19 19 19 19 1 3 3 3 1 19 19 19 19 19 19 19 19 19 0 0 0 19 19 19 19 19 19 19 19 19 5 5 5 5 5 5 5 5 19 19 19 19 19 19 19 19 
19 19 19 19 19 19 19 19 1 3 3 3 1 19 19 19 19 19 19 19 19 19 19 5 19 19 19 19 19 19 19 19 19 19 5 5 5 5 5 5 5 5 19 19 19 19 19 19 19 19 
19 19 19 19 19 19 19 19 1 1 0 1 1 19 19 19 19 19 19 19 19 19 19 5 19 19 19 19 19 19 19 19 19 19 5 5 5 5 5 5 5 5 19 19 19 19 19 19 19 19 
19 19 19 19 19 19 19 19 19 19 0 19 19 19 19 19 19 19 19 19 19 19 19 5 19 19 19 19 19 19 19 19 19 19 19 5 5 5 5 5 5 19 19 19 19 19 19 19 19 19 
19 19 19 19 19 19 19 19 19 19 0 19 19 19 19 19 19 19 19 19 19 19 19 5 19 19 19 19 19 19 19 19 19 19 19 19 19 19 5 19 19 19 19 19 19 19 19 19 19 19 
19 19 19 19 19 19 19 19 19 19 0 19 19 19 19 19 19 19 19 19 19 19 19 5 19 19 19 19 19 19 19 19 19 19 19 19 19 19 5 19 19 19 19 19 19 19 19 19 19 19 
19 19 19 19 19 19 19 19 19 19 0 19 19 19 19 19 19 19 19 19 19 19 19 5 19 19 19 19 19 19 19 19 19 19 19 19 19 19 5 19 19 19 19 19 19 19 19 19 19 19 
19 19 19 19 19 19 19 19 0 0 0 19 19 19 19 19 19 19 19 19 19 19 19 5 19 19 19 19 19 19 19 19 19 19 19 19 19 19 5 19 19 19 19 19 19 19 19 19 19 19 
19 19 19 19 19 19 19 19 0 19 19 19 19 19 19 19 19 19 19 19 19 19 19 5 19 19 19 19 19 19 19 19 19 19 19 19 19 19 5 19 19 19 19 19 19 19 19 19 19 19 
19 19 19 19 19 19 19 19 0 19 19 19 19 19 19 19 19 19 19 19 19 19 0 5 0 19 19 19 19 19 19 19 19 19 19 19 5 5 5 19 19 19 19 19 19 19 19 19 19 19 
19 19 19 19 19 19 19 19 0 19 19 19 19 19 19 19 19 19 19 19 19 0 0 5 0 0 19 19 19 19 19 19 19 19 19 19 5 19 19 19 19 19 19 19 19 19 19 19 19 19 
19 19 19 19 19 19 19 19 0 19 19 19 19 19 19 19 19 19 19 19 0 0 0 5 0 0 0 19 19 19 19 19 19 19 19 5 5 19 19 19 19 19 19 19 19 19 19 19 19 19 
19 19 19 19 19 19 19 19 0 19 19 19 5 5 5 5 5 5 5 5 5 5 5 5 5 5 5 5 5 5 5 5 5 5 5 5 5 19 19 19 19 19 19 19 19 19 19 19 19 19 
19 19 19 19 19 19 19 19 0 19 19 19 0 19 19 19 19 19 19 19 0 0 0 5 0 0 0 19 19 19 19 19 19 19 19 19 5 19 19 19 19 19 19 19 19 19 19 19 19 19 
19 19 19 19 19 19 19 19 0 19 19 19 0 19 19 19 19 19 19 19 19 0 0 5 0 0 19 19 19 19 19 19 19 19 19 19 5 19 19 19 19 19 19 19 19 19 19 19 19 19 
19 19 19 19 19 19 19 19 0 19 19 19 0 19 19 19 19 19 19 19 19 19 0 5 0 19 19 19 19 19 19 19 19 19 19 19 5 19 19 19 19 19 19 19 19 19 19 19 19 19 
19 19 19 19 19 19 19 19 0 19 19 19 0 0 0 19 19 19 19 19 19 19 19 5 19 19 19 19 19 19 19 19 19 19 19 19 5 19 19 19 19 19 19 19 19 19 19 19 19 19 
19 19 19 19 19 19 19 19 0 19 19 19 19 19 0 19 19 19 19 19 19 19 19 5 19 19 19 19 19 19 19 19 19 19 19 19 5 19 19 19 19 19 19 19 19 19 19 19 19 19 
19 19 19 19 19 19 19 19 0 19 19 19 19 19 0 19 19 19 19 19 19 19 19 5 19 19 19 0 19 19 19 19 19 19 19 0 5 19 19 19 19 19 19 19 19 19 19 19 19 19 
19 19 19 19 19 19 19 19 0 19 19 19 19 19 0 19 19 19 19 19 19 19 19 5 19 19 19 19 19 19 0 19 19 19 19 19 5 19 19 19 19 19 19 19 19 19 19 19 19 19 
19 19 19 19 19 19 19 19 0 0 0 0 0 0 0 19 19 19 19 19 19 19 19 5 19 19 19 19 19 19 0 19 19 19 19 19 5 19 19 19 19 19 19 19 19 19 19 19 19 19 
19 19 19 19 19 19 19 19 0 0 0 0 0 0 0 19 19 19 19 19 19 19 19 5 19 19 19 19 19 19 19 19 19 19 19 19 0 19 19 19 19 19 19 19 19 19 19 19 19 19 
19 19 19 19 19 19 19 19 0 0 0 0 0 0 0 19 19 19 19 19 19 19 19 5 19 19 19 19 19 19 19 19 19 19 19 0 0 0 19 19 19 19 19 19 19 19 19 19 19 19 
19 19 19 19 19 19 19 19 0 0 0 0 0 0 0 19 19 19 19 19 19 19 19 5 19 19 19 19 19 19 19 19 19 19 19 0 0 0 19 19 19 19 19 19 19 19 19 19 19 19 
19 19 19 19 19 19 19 19 0 0 0 0 0 0 0 19 19 19 19 19 19 19 19 5 19 19 19 19 19 19 19 19 19 19 19 0 0 0 19 19 19 19 19 19 19 19 19 19 19 19 
19 19 19 19 19 19 19 19 0 0 0 0 0 0 0 19 19 19 19 19 19 19 19 5 19 19 19 19 19 19 19 19 19 19 19 0 0 0 19 19 19 19 19 19 19 19 19 19 19 19 
19 19 19 19 19 19 19 19 19 19 19 19 19 19 19 19 19 19 19 19 19 19 19 5 19 19 19 19 19 19 19 19 19 19 19 0 0 0 19 19 19 19 19 19 19 19 19 19 19 19 
19 19 19 19 19 19 19 19 19 19 19 19 19 19 19 19 19 19 19 0 0 0 0 0 0 0 0 19 19 19 19 19 19 19 0 0 0 0 0 19 19 19 19 19 19 19 19 19 19 19 
19 19 19 19 19 19 19 19 19 19 19 19 19 19 19 19 19 19 0 0 0 0 0 0 0 0 0 0 19 19 0 19 19 0 0 0 0 0 0 19 19 19 19 19 19 19 19 19 19 19 
19 19 19 19 19 19 19 19 19 19 19 19 19 19 19 19 19 19 0 0 0 0 0 0 0 0 0 0 19 19 19 19 0 0 0 0 0 0 0 19 19 19 19 19 19 19 19 19 19 19 
19 19 19 19 19 19 19 19 19 19 19 19 19 0 19 19 19 19 0 0 0 0 0 0 0 0 0 0 0 19 19 19 0 0 0 0 0 19 0 19 19 19 19 19 19 19 19 19 19 19 
19 19 19 19 19 19 19 19 19 19 19 19 19 19 19 19 19 19 0 0 0 0 0 0 0 0 0 0 0 0 0 0 0 0 19 0 0 0 0 19 19 19 19 19 19 19 19 19 19 19 
19 19 19 19 19 19 19 19 19 19 19 19 19 0 19 19 19 19 19 0 0 0 0 0 0 0 0 19 19 19 19 0 0 0 0 0 0 0 0 19 19 19 19 19 19 19 19 19 19 19 
19 19 19 19 19 19 19 19 19 19 19 19 19 19 19 19 19 19 19 19 0 0 0 0 0 0 19 19 19 19 19 0 0 19 0 0 19 0 0 19 19 19 19 19 19 19 19 19 19 19 
19 19 19 19 19 19 19 19 19 19 19 19 19 19 19 19 19 19 19 19 19 19 19 19 19 19 19 19 19 19 19 19 0 0 0 0 0 0 19 19 19 19 19 19 19 19 19 19 19 19 
19 19 19 19 19 19 19 19 19 19 19 19 19 19 19 19 19 19 19 19 19 19 19 19 19 19 19 19 19 19 19 19 19 19 19 19 19 19 19 19 19 19 19 19 19 19 19 19 19 19 
19 19 19 19 19 19 19 19 19 19 19 19 19 19 19 19 19 19 19 19 19 19 19 19 19 19 19 19 19 19 19 19 19 19 19 19 19 19 19 19 19 19 19 19 19 19 19 19 19 19 
19 19 19 19 19 19 19 19 19 19 19 19 19 19 19 19 19 19 19 19 19 19 19 19 19 19 19 19 19 19 19 19 19 19 19 19 19 19 19 19 19 19 19 19 19 19 19 19 19 19 
19 19 19 19 19 19 19 19 19 19 19 19 19 19 19 19 19 19 19 19 19 19 19 19 19 19 19 19 19 19 19 19 19 19 19 19 19 19 19 19 19 19 19 19 19 19 19 19 19 19 
19 19 19 19 19 19 19 19 19 19 19 19 19 19 19 19 19 19 19 19 19 19 19 19 19 19 19 19 19 19 19 19 19 19 19 19 19 19 19 19 19 19 19 19 19 19 19 19 19 19 
19 19 19 19 19 19 19 19 19 19 19 19 19 19 19 19 19 19 19 19 19 19 19 19 19 19 19 19 19 19 19 19 19 19 19 19 19 19 19 19 19 19 19 19 19 19 19 19 19 19 