19 19 19 19 19 19 19 19 19 19 19 19 19 19 19 19 19 19 19 19 19 19 19 19 19 19 19 19 19 19 19 19 19 19 19 19 19 19 19 19 19 19 19 19 19 19 19 19 19 19 
19 19 19 19 19 19 19 19 19 19 19 19 19 19 19 19 19 19 19 19 19 19 19 19 19 19 19 19 19 19 19 19 19 19 19 19 19 19 19 19 19 19 19 19 19 19 19 19 19 19 
19 19 19 19 19 19 19 19 19 19 19 19 19 19 19 19 19 19 19 19 3 22 22 22 22 22 3 19 19 19 19 19 19 19 19 19 19 19 19 19 19 19 19 19 19 19 19 19 19 19 
19 19 19 19 19 19 19 19 19 19 19 19 19 19 19 19 19 19 19 19 22 22 22 22 22 22 22 19 19 19 19 19 19 19 19 19 19 19 19 19 19 19 19 19 19 19 19 19 19 19 
19 19 19 19 19 19 19 19 19 19 19 19 19 19 19 19 19 19 19 19 22 22 22 22 22 22 22 19 19 19 19 19 19 19 19 19 19 19 19 19 19 19 19 19 19 19 19 19 19 19 
19 19 19 19 19 19 19 19 19 19 19 19 19 19 19 19 19 19 19 19 22 22 22 22 22 22 22 19 19 19 19 19 19 19 19 19 19 19 19 19 19 19 19 19 19 19 19 19 19 19 
19 19 19 19 19 19 19 19 20 20 20 20 20 19 19 19 19 19 19 19 19 29 29 29 29 29 19 19 19 19 19 19 19 19 19 19 19 19 19 19 19 19 19 19 19 19 19 19 19 19 
19 19 19 19 19 19 19 19 20 1 1 1 20 19 19 19 19 19 19 19 3 3 3 5 3 3 3 19 19 19 19 19 19 3 5 5 5 5 5 5 5 19 19 19 19 19 19 19 19 19 
19 19 19 19 19 19 19 19 20 1 1 1 20 19 19 19 19 19 19 19 19 3 3 3 3 3 19 19 19 19 19 19 19 19 5 5 5 5 5 5 5 5 19 19 19 19 19 19 19 19 
19 19 19 19 19 19 19 19 20 1 1 1 20 19 19 19 19 19 19 19 19 19 3 3 3 19 19 19 19 19 19 19 19 19 5 5 5 5 5 5 5 5 19 19 19 19 19 19 19 19 
19 19 19 19 19 19 19 19 20 1 1 1 20 19 19 19 19 19 19 19 19 19 19 5 19 19 19 19 19 19 19 19 19 19 5 5 5 5 5 5 5 5 19 19 19 19 19 19 19 19 
19 19 19 19 19 19 19 19 20 20 1 20 20 19 19 19 19 19 19 19 19 19 19 5 19 19 19 19 19 19 19 19 19 19 5 5 5 5 5 5 5 5 19 19 19 19 19 19 19 19 
19 19 19 19 19 19 19 19 19 19 3 19 19 19 19 19 19 19 19 19 19 19 19 5 19 19 19 19 19 19 19 19 19 19 19 5 5 5 5 5 5 19 19 19 19 19 19 19 19 19 
19 19 19 19 19 19 19 19 19 19 3 19 19 19 19 19 19 19 19 19 19 19 19 5 19 19 19 19 19 19 19 19 19 19 19 19 19 19 5 19 19 19 19 19 19 19 19 19 19 19 
19 19 19 19 19 19 19 19 19 19 3 19 19 19 19 19 19 19 19 19 19 19 19 5 19 19 19 19 19 19 19 19 19 19 19 19 19 19 5 19 19 19 19 19 19 19 19 19 19 19 
19 19 19 19 19 19 19 19 19 19 3 19 19 19 19 19 19 19 19 19 19 19 19 5 19 19 19 19 19 19 19 19 19 19 19 19 19 19 5 19 19 19 19 19 19 19 19 19 19 19 
19 19 19 19 19 19 19 19 3 3 3 19 19 19 19 19 19 19 19 19 19 19 19 5 19 19 19 19 19 19 19 19 19 19 19 19 19 19 5 19 19 19 19 19 19 19 19 19 19 19 
19 19 19 19 19 19 19 19 3 19 19 19 19 19 19 19 19 19 19 19 19 19 19 5 19 19 19 19 19 19 19 19 19 19 19 19 19 19 5 19 19 19 19 19 19 19 19 19 19 19 
19 19 19 19 19 19 19 19 3 19 19 19 19 19 19 19 19 19 19 19 19 19 3 5 3 19 19 19 19 19 19 19 19 19 19 19 5 5 5 19 19 19 19 19 19 19 19 19 19 19 
19 19 19 19 19 19 19 19 3 19 19 19 19 19 19 19 19 19 19 19 19 3 3 5 3 3 19 19 19 19 19 19 19 19 19 19 5 19 19 19 19 19 19 19 19 19 19 19 19 19 
19 19 19 19 19 19 19 19 3 19 19 19 19 19 19 19 19 19 19 19 3 3 3 5 3 3 3 19 19 19 19 19 19 19 19 5 5 19 19 19 19 19 19 19 19 19 19 19 19 19 
19 19 19 19 19 19 19 19 3 19 19 19 5 5 5 5 5 5 5 5 5 5 5 5 5 5 5 5 5 5 5 5 5 5 5 5 5 19 19 19 19 19 19 19 19 19 19 19 19 19 
19 19 19 19 19 19 19 19 3 19 19 19 3 19 19 19 19 19 19 19 3 3 3 5 3 3 3 19 19 19 19 19 19 19 19 19 5 19 19 19 19 19 19 19 19 19 19 19 19 19 
19 19 19 19 19 19 19 19 3 19 19 19 3 19 19 19 19 19 19 19 19 3 3 5 3 3 19 19 19 19 19 19 19 19 19 19 5 19 19 19 19 19 19 19 19 19 19 19 19 19 
19 19 19 19 19 19 19 19 3 19 19 19 3 19 19 19 19 19 19 19 19 19 3 5 3 19 19 19 19 19 19 19 19 19 19 19 5 19 19 19 19 19 19 19 19 19 19 19 19 19 
19 19 19 19 19 19 19 19 3 19 19 19 3 3 3 19 19 19 19 19 19 19 19 5 19 19 19 19 19 19 19 19 19 19 19 19 5 19 19 19 19 19 19 19 19 19 19 19 19 19 
19 19 19 19 19 19 19 19 3 19 19 19 19 19 3 19 19 19 19 19 19 19 19 5 19 19 19 19 19 19 19 19 19 19 19 19 5 19 19 19 19 19 19 19 19 19 19 19 19 19 
19 19 19 19 19 19 19 19 3 19 19 19 19 19 3 19 19 19 19 19 19 19 19 5 19 19 19 3 19 19 19 19 19 19 19 3 5 19 19 19 19 19 19 19 19 19 19 19 19 19 
19 19 19 19 19 19 19 19 3 19 19 19 19 19 3 19 19 19 19 19 19 19 19 5 19 19 19 19 19 19 3 19 19 19 19 19 5 19 19 19 19 19 19 19 19 19 19 19 19 19 
19 19 19 19 19 19 19 19 3 3 3 3 3 3 3 19 19 19 19 19 19 19 19 5 19 19 19 19 19 19 3 19 19 19 19 19 5 19 19 19 19 19 19 19 19 19 19 19 19 19 
19 19 19 19 19 19 19 19 3 3 3 3 3 3 3 19 19 19 19 19 19 19 19 5 19 19 19 19 19 19 19 19 19 19 19 19 3 19 19 19 19 19 19 19 19 19 19 19 19 19 
19 19 19 19 19 19 19 19 3 3 3 3 3 3 3 19 19 19 19 19 19 19 19 5 19 19 19 19 19 19 19 19 19 19 19 3 3 3 19 19 19 19 19 19 19 19 19 19 19 19 
19 19 19 19 19 19 19 19 3 3 3 3 3 3 3 19 19 19 19 19 19 19 19 5 19 19 19 19 19 19 19 19 19 19 19 3 3 3 19 19 19 19 19 19 19 19 19 19 19 19 
19 19 19 19 19 19 19 19 3 3 3 3 3 3 3 19 19 19 19 19 19 19 19 5 19 19 19 19 19 19 19 19 19 19 19 3 3 3 19 19 19 19 19 19 19 19 19 19 19 19 
19 19 19 19 19 19 19 19 3 3 3 3 3 3 3 19 19 19 19 19 19 19 19 5 19 19 19 19 19 19 19 19 19 19 19 3 3 3 19 19 19 19 19 19 19 19 19 19 19 19 
19 19 19 19 19 19 19 19 19 19 19 19 19 19 19 19 19 19 19 19 19 19 19 5 19 19 19 19 19 19 19 19 19 19 19 3 3 3 19 19 19 19 19 19 19 19 19 19 19 19 
19 19 19 19 19 19 19 19 19 19 19 19 19 19 19 19 19 19 19 3 3 3 3 3 3 3 3 19 19 19 19 19 19 19 3 3 3 3 3 19 19 19 19 19 19 19 19 19 19 19 
19 19 19 19 19 19 19 19 19 19 19 19 19 19 19 19 19 19 3 3 3 3 3 3 3 3 3 3 19 19 3 19 19 3 3 3 3 3 3 19 19 19 19 19 19 19 19 19 19 19 
19 19 19 19 19 19 19 19 19 19 19 19 19 19 19 19 19 19 3 3 3 3 3 3 3 3 3 3 19 19 19 19 3 3 3 3 3 3 3 19 19 19 19 19 19 19 19 19 19 19 
19 19 19 19 19 19 19 19 19 19 19 19 19 3 19 19 19 19 3 3 3 3 3 3 3 3 3 3 3 19 19 19 3 3 3 3 3 19 3 19 19 19 19 19 19 19 19 19 19 19 
19 19 19 19 19 19 19 19 19 19 19 19 19 19 19 19 19 19 3 3 3 3 3 3 3 3 3 3 3 3 3 3 3 3 19 3 3 3 3 19 19 19 19 19 19 19 19 19 19 19 
19 19 19 19 19 19 19 19 19 19 19 19 19 3 19 19 19 19 19 3 3 3 3 3 3 3 3 19 19 19 19 3 3 3 3 3 3 3 3 19 19 19 19 19 19 19 19 19 19 19 
19 19 19 19 19 19 19 19 19 19 19 19 19 19 19 19 19 19 19 19 3 3 3 3 3 3 19 19 19 19 19 3 3 19 3 3 19 3 3 19 19 19 19 19 19 19 19 19 19 19 
19 19 19 19 19 19 19 19 19 19 19 19 19 19 19 19 19 19 19 19 19 19 19 19 19 19 19 19 19 19 19 19 3 3 3 3 3 3 19 19 19 19 19 19 19 19 19 19 19 19 
19 19 19 19 19 19 19 19 19 19 19 19 19 19 19 19 19 19 19 19 19 19 19 19 19 19 19 19 19 19 19 19 19 19 19 19 19 19 19 19 19 19 19 19 19 19 19 19 19 19 
19 19 19 19 19 19 19 19 19 19 19 19 19 19 19 19 19 19 19 19 19 19 19 19 19 19 19 19 19 19 19 19 19 19 19 19 19 19 19 19 19 19 19 19 19 19 19 19 19 19 
19 19 19 19 19 19 19 19 19 19 19 19 19 19 19 19 19 19 19 19 19 19 19 19 19 19 19 19 19 19 19 19 19 19 19 19 19 19 19 19 19 19 19 19 19 19 19 19 19 19 
19 19 19 19 19 19 19 19 19 19 19 19 19 19 19 19 19 19 19 19 19 19 19 19 19 19 19 19 19 19 19 19 19 19 19 19 19 19 19 19 19 19 19 19 19 19 19 19 19 19 
19 19 19 19 19 19 19 19 19 19 19 19 19 19 19 19 19 19 19 19 19 19 19 19 19 19 19 19 19 19 19 19 19 19 19 19 19 19 19 19 19 19 19 19 19 19 19 19 19 19 
19 19 19 19 19 19 19 19 19 19 19 19 19 19 19 19 19 19 19 19 19 19 19 19 19 19 19 19 19 19 19 19 19 19 19 19 19 19 19 19 19 19 19 19 19 19 19 19 19 19 